9999999999111111119999999999999999999999999999999999999999999999
9999999999991111111199999999999999999999999999999999999999999999
9999999999111111119999999999999999999999999999999999999999999999
9999999999999911111111999999999999999999999999999999999999999999
9999999999999999991111111199999999999999999999999999999999999999
9999999999999999999999111111119999999999999999999999999999999999
9999999999999999999999999991111111111111111199999999999999999999
9999999999999999999911111111999999999999999999999999999999999999
9999999999999999991111199999999999999999999999999999999999999999
9999999999999999991111111111111111119999999999999999999999999999
9999999999999999991111111111111111119999999999999999999999999999
9999999999999999991111111111111111119999999999999999999999999999
9999999999999999991111111111999999999999999999999999999999999999
9999999999999999991111111111111111119999999999999999999999999999
9999999911111111111111111199999999999999999999999999999999999999
9999999999111111119999999999999999999999999999999999999999999999
9999999999991111111199999999999999999999999999999999999999999999
9999999999111111119999999999999999999999999999999999999999999999
9999999999999911111111999999999999999999999999999999999999999999
9999999999999999991111111199999999999999999999999999999999999999
9999999999999999999999111111119999999999999999999999999999999999
9999999999999999999999999991111111111111111199999999999999999999
9999999999999999999911111111999999999999999999999999999999999999
9999999999999999991111199999999999999999999999999999999999999999
9999999999999999991111111111111111119999999999999999999999999999
9999999999999999991111111111111111119999999999999999999999999999
9999999999999999991111111111111111119999999999999999999999999999
9999999999999999991111111111999999999999999999999999999999999999
9999999999999999991111111111111111119999999999999999999999999999
9999999911111111111111111199999999999999999999999999999999999999
9999999999991111111199999999999999999999999999999999999999999999
9999999999999999911111111999999999999999999999999999999999999999