1111111999999999999999999999999999999999999999111111199999999999
9911111119999999999999999999999999999999999911111119999999999999
9111111199999999999999999999999999999999991111111999999999999999
9111111199999999999999999999999999999999911111119999999999999999
9111111199999999999999999999999999999999111111199999999999999999
9911111119999999999999999999999999999911111119999999999999999999
9999111111199999999999999999999999991111111999999999999999999999
9991111111999999999999999999999999111111199999999999999999999999
9111111199999999999999999999999911111119999999999999999999999999
9111111199999999999999999999999111111199999999999999999999999999
1111111999999999999999999999991111111999999999999999999999999999
1111111999999999999999999999991111111999999999999999999999999999
1111111999999999999999999999999991111111999999999999999999999999
1111111999999999999999999999999991111111999999999999999999999999
1111111999999999999999999999999991111111999999999999999999999999
1111111999999999999999999999999999911111119999999999999999999999
1111111999999999999999999999999999999911111119999999999999999999
1111111999999999999999999999999999999111111199999999999999999999
1111111999999999999999999999999999991111111999999999999999999999
1111111999999999999999999999999999991111111999999999999999999999
1111111999999999999999999999999999991111111999999999999999999999
9111111199999999999999999999999999991111111999999999999999999999
9911111119999999999999999999999999991111111999999999999999999999
9999111111199999999999999999999999991111111999999999999999999999
9999991111111999999999999999999999991111111999999999999999999999
9999999911111119999999999999999999991111111999999999999999999999
9999999999911111119999999999999991111111999999999999999999999999
9999999999999911111119999999999111111199999999999999999999999999
9999999999999999911111119999911111119999999999999999999999999999
9999999999999999999911111111111111999999999999999999999999999999
9999999999999999999999911111119999999999999999999999999999999999